{
  "Tiles": [
    [ 1, 1, 1, 1, 1, 1, 1, 1, 1, 1, 1, 1, 1, 1, 1, 1 ],
    [ 1, 0, 0, 0, 0, 0, 0, 0, 0, 0, 0, 0, 0, 0, 0, 1 ],
    [ 1, 0, 0, 0, 0, 0, 0, 0, 0, 0, 0, 0, 0, 0, 0, 1 ],
    [ 1, 0, 0, 0, 0, 0, 0, 0, 0, 0, 0, 0, 0, 0, 0, 1 ],
    [ 1, 0, 0, 0, 0, 0, 0, 0, 0, 0, 0, 0, 0, 0, 0, 1 ],
    [ 1, 0, 0, 0, 0, 0, 0, 0, 0, 0, 0, 0, 0, 0, 0, 1 ],
    [ 1, 0, 0, 0, 0, 0, 0, 0, 0, 0, 0, 0, 0, 0, 0, 1 ],
    [ 1, 0, 0, 0, 0, 0, 0, 0, 0, 0, 0, 0, 0, 0, 0, 1 ],
    [ 1, 0, 0, 1, 1, 0, 0, 0, 0, 0, 0, 1, 1, 0, 0, 1 ],
    [ 1, 0, 0, 0, 0, 0, 0, 0, 0, 0, 0, 0, 0, 0, 0, 1 ],
    [ 0, 0, 0, 0, 0, 0, 0, 0, 0, 0, 0, 0, 0, 0, 0, 0 ],
    [ 0, 0, 0, 0, 0, 0, 0, 0, 0, 0, 0, 0, 0, 0, 0, 0 ],
    [ 1, 1, 1, 1, 1, 1, 1, 1, 1, 1, 1, 1, 1, 1, 1, 1 ]
  ],
  "Entities": [
    {
      "Type": "PlayerSpawner",
      "Id": "",
      "X": 1,
      "Y": 1
    },
    {
      "Type": "PlayerSpawner",
      "Id": "left",
      "X": 1,
      "Y": 1
    },
    {
      "Type": "PlayerSpawner",
      "Id": "right",
      "X": 13,
      "Y": 1
    },
    {
      "Type": "Transition",
      "X": 15,
      "Y": 2,
      "Parameters": {
        "TargetMap": "transition",
        "TargetSpawn": "left"
      }
    },
    {
      "Type": "Transition",
      "X": 0,
      "Y": 2,
      "Parameters": {
        "TargetMap": "transition",
        "TargetSpawn": "right"
      }
    }
  ]
}